format maze
+---+---+---+
s   |       |
+   +---+---+
|           |
+---+---+   +
|           e
+---+---+---+
